April	April
Arabian	Arab
Arabic	Arab
Atlantic	Lautan Atlantik
Atlantic Ocean	Lautan Atlantik
August	Agustus
China	Cina
Chinese	Cina
Christmas	Hari Natal
December	Desember
Dutch	Belanda
English	Inggris
Europa	Eropah
Europe	Eropah
February	Pebruari
French	Perancis
Friday	Jumat
God	Allah
Indonesia	Indonesia
January	Januari
Java	Jawa
July	Juli
June	Juni
March	Maret
May	Mei
Mohammedan	orang Islam
Monday	Senin
Moslem	orang Islam
Muslim	orang Islam
Mussulman	orang Islam
November	Nopember
October	Oktober
Portuguese	Portugis
Sabbath	Sabtu
Sanskrit	Sansekerta
Saturday	Sabtu
September	September
Sunday	Ahad
Sunday  Minggu
Thursday	Kamis
Tuesday	Selasa
Wednesday	Rabu
West	barat
Yule	Hari Natal
abbreviate	singkat
abbreviate  menyingkat
abbreviation	singkatan
aberration	salah	kesalahan
abet	bantu	membantu
abide	harapkan	mengharapkan	menunggu	tunggu	derita	menderita
abjure	batalkan	membatalkan
able	sanggup
abolish	batalkan	membatalkan
abolition	pembatalan
abort	gagal
about	lebih kurang
above-board	jujur
abridge	singkat	menyingkat
abroad	luar negeri
abrogate	batalkan	membatalkan
abrogation	pembatalan
absent	absen	tidak hadir	absen	tidak hadir
absolute	lengkap
academic	pelajar
accede	setuju
accept	menerima	terima
acceptance	penerimaan
accident	kecelakaan
accomodate	bantu	membantu
accompany	antar	mengantar
accomplish	capai	mencapai
accord	perbolehkan	memperbolehkan
accordion	harmonika
account	rekening	sebab	perhitungan
account for	menyatakan
accuse	dakwa	mendakwa
accustomed	biasa
acerbic	pahit
ache	sakit
achieve	capai	mencapai
acknowledge	mengaku
acknowledgement	pengakuan
across	lintang
across from	lawan
act	aruh	mempengaruhi
action	pengaruh
activate	membangkitkan
active	aktif	aktif	aktif
actor	peran
ad	adpertensi	iklan	pemberitahuan
add	tambah	menambah
addition	tambahan
addled	buruk
address	alamat
add up	tambah	menambah
adjudication	hukuman
administration	administrasi	administrasi
admission	penerimaan	pengakuan
admit	mengaku	perbolehkan	memperbolehkan
admixture	campuran
adult	orang dewasa
advert	menanti
advertise	memberi-tahu
advertisement	adpertensi	iklan	pemberitahuan
advice	nasehat	nasihat
advise	mensasihatkan
aeroplane	pesawat terbang
affable	baik	baik-haiti
affair	perkara	hal
affect	aruh	mempengaruhi
affection	kasih
afford	perbolehkan	memperbolehkan	menghasilkan
afraid	takut	takut	takut
afresh	lagi	pula	lagi
after	sesudah
afternoon	petang
again	lagi	pula	lagi
against	lawan
age	umur
agent	agen	alat	perkakas
agonize	aniaya	menganiaya
agree	setuju
ague	demam
ahead	sebelumnya
aid	pembantu	bantu	membantu	bantuan	pembantu	bantu	membantu	bantuan
ailment	penyakit
aim	maksud
air	angin	hawa	udara
airplane	pesawat terbang
airport	lapangan-terbang
alien	asing
all	semua
allow	perbolehkan	memperbolehkan
all over again	lagi	pula
all the	tiap
almost	hampir
alms	derma
alone	sendiri
alphabet	abjad
already	sudah
altogether	semua
amount	jumlah
anew	lagi	pula
announce	memberi-tahu
annul	batalkan	membatalkan
apart	khusus
apartment	flat
ape	kera
appraise	menaksir	taksir
approximately	lebih kurang
arm	lengan
arouse	membanguni
arrack	kacang
arrange	atur	mengatur
article	benda
as	sebagai	sebagai	begini	begitu
ash	abu
ask	minta
assist	bantu	membantu	bantu	membantu
assistant	pembantu
assistent	pembantu
attain	capai	mencapai
attempt	coba	mencoba
attend	kunjungi	mengunjungi
at last	akhirnya
aureole	praba
author	pengarang	pengarang
average	tengah
avoid	hindari	menghindari
await	harapkan	mengharapkan	menunggu	tunggu
awaken	membanguni
a little	agak
a lot of	banyak
baby	baybi
bad	buruk
bag	karung	sak	tas	karung	sak	tas
banana	pisang
basin	mangkuk
basket	keranjang
beach	pantai
bean	kacang
bear	lahir	menghasilkan	derita	menderita
beard	janggut
beautiful	cantik	indah
behind	sesudah
bench	bangku
beyond	lintang
be willing to	mau
big	besar	raya
bill	karcis	rekening
bind	ikat	mengikat
birth	kelahiran
birthday	ulang-tahun
bitter	pahit
black	hitam
blanket	selimut
blend	mencampuri
bloom	bunga
blow	embus	mengembus
blue	biru
boar	babi-hutan
boarding house	asrama
boarding school	asrama
body	badan
bone	tulang
book	buku	kitab
border	pinggir	tepi
bosom	dada
boss	majikan
bottle	botol
bough	dahan
boutique	toko
bowl	mangkuk
box	kotak
boy	jongos	pelayan
bracelet	gelang
brain	otak
branch	dahan
brave	berani
bread	roti
break	pecahkan	mempecahkan	pecah
breakfast	makan-pagi	sarapan
breast	dada
breath	nafas
breathe	bernafas
breed	didik	mendidik
bridge	jembatan
brief	pendek
brim	pinggir	tepi
bring	ambil	mengambil
bring up	didik	mendidik
brink	pinggir	tepi
broad	luas
brother-in-law	ipar laki-laki
brow	alis
brush	menyikat	sikat
bucket	ember
buffalo	kerbau
buffoon	badut
building	bangunan
burden	memuati	muatan
burdensome	berat
burn	bakar	membakar	bakar	membakar
business	perkara
business deal	perkara
button	kancing	kancing
by now	sudah
calculation	rekening
call on	kunjungi	mengunjungi
cancel	batalkan	membatalkan
candidate	calon
candle	lilin
capable	sanggup
capture	menangkap	tangkap
careless	lalai
carry	angkat	mengangkat
cart	gerobak
case	perkara	hal	hal
catch	menangkap	tangkap	memukul	pukul
cause	membangkitkan
centennial	abad
century	abad
chair	kursi
chamber	kamar
chance	kesempatan
change	mengubah	ubah	berubah
chaos	kekacauan
chaotic	kacau	kacau
character	alam	tanda
charcoal	arang
charge	bayarkan	muatan
chariot	gerobak
charity	derma
charming	cantik
chat	mengobrol
chatter	mengobrol
cheap	murah	murah
cheerful	gembira
chest	dada
chick	anak ayam
chicken	anak ayam	ayam
chief	majikan
chocolate	coklat
choice	pilihan
choose	memilih	pilih
church-building	gereja
church	gereja
cigarette	rokok
cinder	abu
cinema	bioskop
clarify	menyatakan
class	kelas
clean	bersih	membersihkan
cleanse	membersihkan
clear	nyata
client	langganan
climate	iklim
clothes	pakaian
clothing	pakaian
cloud	awan
clown	badut
co-operate	bantu	membantu
coat	jas	jas
coconut	kelapa
coffee	kopi
collect	kumpulkan	mengumpulkan
collide	menubruk	tubruk
collision	tubrukan
colour	warna
comb	menyisir	sisir	sisir
come about	terjadi
come to an end	berakhir
commend	anjur	menganjurkan
common	biasa
company	firma
compare	menyamakan
compel	paksa	memaksa
complete	lengkap
compose	karang	mengarang
comprise	berisi
conclusion	akibat
conduct	pimpin	pimpin
confess	mengaku	mengaku
confession	pengakuan	pengakuan
connect	ikat	mengikat
consent	setuju
consequence	akibat
consistency	akibat
contain	berisi
contented	puas
contribute	menyumbang	sumbang
conversation	percakapan
cool	sejuk
cooperate	bantu	membantu
copy	salin	menyalin
cord	tali	tampar
correct	benar	betul
costly	mahal
counsel	mensasihatkan	nasehat	nasihat
country	darat	negeri	tanah
count in	tambah	menambah
courageous	berani
courteous	adab	beradab	adab	beradab	sopan
cow	sapi
crazy	gila
criminal	jahat	penjahat
cruel	kejam
cucumber	mentimun
cup	cangkir
currently	dewasa ini	sekarang
custom	adat	kebiasaan
customary	biasa
customer	langganan
dampen	membasahi
danger	bahaya
dangerous	berbahaya
dazed	bingung
deaf	tuli
dear	mahal	mahal	mahal	mahal
decide	memutuskan	putuskan
decision	keputusan
declaration of policy	acara	rencana
degree	derajat
devil	setan
difference	perbedaan
dig	gali	menggali
diligent	giat
diminutive	kecil
dining-room	kamar-makan
direct	pimpin
direction	arah
disappear	hilang
disease	penyakit
distinct	nyata
distinctive	agung
district	bumi
divide	bagi	membagi
doctor	tabib
don’t mention it	tidak apa apa
doubt	bimbang
doubtful	bimbang
dozen	dosin
dream	mimpi	bermimpi	impian	mimpi
drowsy	antuk	mengantuk
drug	obat
dry	kering
dust	debu
duty	kewajiban
dye	warna
each	tiap
ear	telinga
edge	pinggir	tepi
edging	pinggir	tepi
educate	didik	mendidik
education	pendidikan	pendidikan
effect	akibat
eight	delapan
elect	memilih	pilih
election	pilihan
electricity	listrik
elephant	gajah
embassy	kedutaan
employ	gunakan	menggunakan
empty	kosong	leher
end	berakhir	akhir
ending	akhir
endure	derita	menderita
end up	berakhir
engine	mesin	motor
enough	agak
enter	masuk
envelope	amplop
error	salah	kesalahan
estimate	menaksir	taksir
eternal	abadi
evade	hindari	menghindari
every	tiap
everybody	tiap
everything	semua
every one	tiap
evident	terbukti
ex-	bekas
examine	uji	menguji
example	umpama
exercise-book	kitab
exercise	melatih	latihan
exert	mempelajari
exhibit	memamerkan	pamerkan
exhibition	pameran
expect	harapkan	mengharapkan	menunggu	tunggu
expenses	penghasilan
expensive	mahal	mahal	mahal
expert	ahli
expire	berakhir
explain	menyatakan
exposition	pameran
extraordinary	luar biasa
extravagant	boros
eye	mata
eyebrow	alis
face	muka
fact	fakta	kenyataan
fail	gagal
faint	lemah
fair	adil
fairly	agak
faithful	setia
false	palsu
family	keluarga	pamili
fast	jepat	lekas
father	bapak	bapak
fertile	subur	subur
fetch	ambil	mengambil	ambil	mengambil
fever	demam
file	baris
fill	isi	mengisi
fill in	isi	mengisi
fill up	isi	mengisi
film	film
finally	akhirnya
fine	cantik	indah
finger	jari
finished	siap
fire	api
firm	firma	gagah
fish	ikan
five	lima
fix up	atur	mengatur
flat-iron	seterika
flat	flat
float	berenang
floor	lantai
flow	alir	mengalir
flower	bunga
fly	terbang	lalat
fold	lipat	melipat	lipatan
folder	kitab
follow	ikuti	mengikuti
fool	gila
force	paksa	memaksa
foreign	asing
foreigner	orang asing
foresee	harapkan	mengharapkan
forgive	mengampuni
former	bekas
formerly	sebelumnya
formidable	luar biasa
for example	misalnya	umpamanya
for instance	misalnya	umpamanya
fountain	mata-air
four	empat
fowl	ayam
friend	kawan
friendly	baik	baik-haiti
fringe	pinggir	tepi
frog	kodok
fruit	buah
fruitful	subur
game	permainan
garage	garasi
garden	kebun
gasolene	bensin
gasoline	bensin
gather	kumpulkan	mengumpulkan
gaunt	kurus	tipis
gay	gembira
generally	kebanyakan
gentle	manis
get	capai	mencapai	ambil	mengambil	menerima	terima
get up	bangkit	bangkit
ghost	hantu
gift	pemberian
give	beri	memberi
give birth to	lahir
give notice	memberi-tahu
give rise to	membangkitkan
glad	senang
goal	maksud
goat	kambing
gold	emas
good-natured	baik	baik-haiti
go in	masuk
grade	derajat	derajat	pangkat
grandmother	nenek
grapple	menangkap	tangkap
grass	rumput
great	besar	raya
green	hijau
greeting	salam
grown-up	orang dewasa
grub	gali	menggali
guide	pimpin	pimpin
guilty	bersalah
gun	bedil
habit	adat	kebiasaan
halo	praba
hammer	palu
hand	pekerja
handsome	cantik	indah
hang onto	memegang	pegang
happen	terjadi
happy	senang
hardworking	giat
have	menerima	terima
head	pimpin
headache	sakit kepala
health	kesehatan
healthy	sehat
heart	jantung
heat	panas
heavy	berat
help	bantu	membantu	bantuan	bantu	membantu	bantuan
helper	pembantu	pembantu
herb	rumput
high-flown	boros
history	sejarah
hit	memukul	pukul
hog	babi
hold	memegang	pegang
hole	lubang
holiday	hari-libur
honest	jujur
hope	harap
horse	kuda
hotel	hotel
hour	jam
housefly	lalat
house of worship	gereja
how	sebagai	sebagai	sebagai
human being	manusia
husband	suami
ice	es
idea	ide	pikiran
ignore	abai	mengabaikan
illness	penyakit
imagination	khayal
imitate	tiru	meniru
imply	berarti
import	mengimpor
important	penting
impossible	tak mungkin
include	berisi
industrious	giat
inexpensive	murah	murah
influence	aruh	mempengaruhi	pengaruh
ink	tinta
insane	gila
insignificant	tiada berarti
instructor	pengajar
instrument	alat
intelligence	akal
intelligent	cerdik
intend	bermaksud
intention	maksud
interesting	menarik
international	internasional
invitation	ajakan	undangan
invite	ajak	mengajak
in action	aktif	aktif
in exchange for	lawan
in what way	sebagai	sebagai
iron	besi	menyeterika	seterika	seterika
iron clothes	menyeterika	seterika
island	pulau
it doesn’t matter	tidak apa apa
jester	badut
join	ikat	mengikat
journey	perjalanan
judge	hakim
judgment	hukuman
juice	air perah
jump	lompat	melompat
just	adil
justice	keadilan
key	kunci
kill	bunuh	membunuh
kind	baik	baik-haiti	jenis	macam
kitchen	dapur
knee	lutut
knife	pisau
know	tahu
knowledge	pengetahuan
know how	tahu
laborer	pekerja
labourer	pekerja
ladder	tangga	tangga
lamp	lampu
land	darat	negeri	tanah
language	bahasa
large	besar	raya
law	hukum
lazy	malas
lead	pimpin	pimpin
leader	majikan
lean	kurus	tipis
leap	lompat	melompat
learn	belajar
leather	kulit
leave out of account	abai	mengabaikan
lemon	jeruk
lesson	pelajaran
letter	surat
lick	bocor
lie	baring	berbaring	mendusta	dusta
light	lemah	enteng
like	sebagai
like that	begini	begitu
line	baris
lip	bibir
liquidate	bunuh	membunuh
list	daftar
little	kecil
liver	hati
load	memuati	muatan
loaf	roti
love	kasih
lovely	cantik	indah	mahal	cantik
low	rendah
loyal	setia
luck	kesempatan
machine	mesin
mad	gila
maid	babu	pelayan
make clean	membersihkan
make use of	gunakan	menggunakan
man	manusia
management	administrasi
manner	cara
many	banyak
mark	tanda
market	pasar
marketplace	pasar
massage	urut
matter	perkara	hal
mattress	tikar
maybe	boleh jadi	mungkin
mayhap	boleh jadi	mungkin
mean	bermaksud	tengah	berarti
meaning	maksud	arti	makna
meaningless	tiada berarti
means	alat	perkakas
meat	daging
medicine	obat
merry	gembira
middle	tengah
milk	susu
mind	hati
mingle	mencampuri
miscarry	gagal
mistake	salah	kesalahan
misunderstand	salah mengerti
misunderstanding	salah faham
mix	mencampuri
mixture	campuran
mode	cara
model	contoh
money	duit	uang
monkey	kera
monument	tugu
mosque	masjid	mesjid
mosquito	nyamuk
motion picture	film
motor	motor
mountain	gunung
mouse	tikus
moustache	kumis
mouth	mulut	mulut	mulut
movie	film
movie theatre	bioskop
much	banyak
mud	lumpur
muscle	urat
nail	paku	kuku
napkin	serbet
narrative	cerita
narrow	sempit
nasty	buruk	jelek
nation	bangsa
nationality	kebangsaan
naturally	memang
nature	alam	alam
nearly	hampir
necessary	perlu
neck	leher
necktie	dasi
need	perlu	keperluan
needle	jarum
neglect	melalaikan
negligent	lalai
never mind	tidak apa apa
night club	night club
night spot	night club
nine	sembilan
no	tidak
nose	hidung
not	tidak
note	karcis
notebook	kitab
notion	faham
nought	nol
nowadays	dewasa ini	sekarang
nurse	jururawat
nuts	gila
object	benda
obligation	kewajiban
obvious	terbukti
occur	terjadi
officer	opsir
of use	berguna	berguna
oil	minyak
once more	lagi
one	satu
onerous	berat
onion	bawang
only	sendiri
on the other side of	lintang
open	buka
operative	pekerja
opinion	pendapat
opposed to	lawan
opposite	lawan
orchid	anggrek
ordinarily	biasanya
ordinary	biasa
orphan	yatim
overcoat	jas	jas
ox	lembu
oyster	kerang
o’clock	jam
packet	bungkusan
page	halaman
pail	ember
pain	sakit
paint	lukis	melukis
painter	pelukis
painting	lukisan
palace	mahligai
pale	pucat
pants	celana
paradise	surga
parcel	bungkusan
pardon	mengampuni
particular	khusus	khusus
pay	bayar	membayar
payment	bayaran	pembayaran	upah
pay attention	menanti
pay attention to	menanti
peace	damai
pelvis	mangkuk
pepper	merica
perchance	boleh jadi	mungkin
perfect	sempurna
perform	masuk
perhaps	boleh jadi	mungkin
peril	bahaya
permit	perbolehkan	memperbolehkan
perplexed	bingung
perspiration	keringat
persuade	bujuk	membujuk
petrol	bensin
phantom	hantu
pharmaceutical	obat
photographer	tukang-portret
physician	tabib
physics	ilmu alam
pick out	memilih	pilih
pick up	ambil	mengambil	kumpulkan	mengumpulkan
picture	lukisan
pig	babi
pill	pil
pillow	bantal
pineapple	nenas
pipe	pipa
place of worship	gereja
plain	nyata
plan	maksud
plane	pesawat terbang
platform	acara	rencana
pleased	puas
plenty of	banyak
plough	membajak	bajak
pocket	saku
poem	syair
polite	adab	beradab	adab	beradab	sopan
pork	daging babi
possibly	boleh jadi	mungkin
potato	kentang
practice	latihan	mempelajari
practise	melatih
pray	bersembahyang
prayer	doa	sembahyang
present	pemberian
pretty	bagus	baik
previously	sebelumnya
pricey	mahal
pride	kebanggaan
produce	menghasilkan
product	hasil
profess	mengaku
programme	acara	rencana
proof	bukti
proud	bangga
prove	membuktikan
punish	menghukum
punishment	hukuman
pure	bersih
purge	membersihkan
purpose	maksud
push	desak	mendesak	dorong	mendorong
putrefy	memburuk
put up with	derita	menderita
quantity	jumlah
quarrel	berbantah
quick	jepat	lekas
quite	agak
rack	kacang
rain	hujan
raise	didik	mendidik
rand	pinggir	tepi
rank	derajat	pangkat	baris
rapid	jepat	lekas
rate	derajat	pangkat	menaksir	taksir
rather	agak	agak	agak
reach	capai	mencapai
ready	siap
realization	faham
realize	mengerti
reason	sebab
receive	menerima	terima	menerima	terima
recline	baring	berbaring
recommend	anjur	menganjurkan
refuse	menolak
register	anjur	menganjurkan
reject	menolak
relatively	agak
religion	agama
remit	batalkan	membatalkan
repeat	ulangi	mengulangi
repose	aso	mengaso
require	perlu
rest	aso	mengaso
result	akibat	akibat
rheumatism	encok
rice	beras
rifle	bedil
right	benar	betul
righteous	adil
righteousness	keadilan
rim	pinggir	tepi
rise	bangkit	bangkit
robust	gagah
roof	atap
room	kamar
root	akar
rope	tali	tampar
rot	memburuk
rotten	buruk
row	baris
run across	memukul	pukul
sack	karung	sak	tas
safe	aman
safety	keamanan	keamanan
sagacious	cerdik
salary	gaji	salaris
sallow	pucat
salt	garam
salty	asin
sand	pasir
sandal	sandal
sap	air perah
satisfied	puas
season	musim
section	bagian
secure	aman
security	keamanan
see	lihat	kunjungi	mengunjungi
send	kirim
sense	faham
sentence	kalimat
separate	khusus	bagi	membagi
serious	penting
servant	babu	pelayan	jongos	pelayan
seven	tujuh
share	bagi	membagi	bagian
sheep	domba
shop	toko
short	pendek	pendek
shorten	singkat	menyingkat
shoulder	bahu
shuffle	mencampuri
sign	bukti	tanda	menandatangani
signal	tanda
signature	tanda-tangan
signify	berarti
simple	sederhana
sing	nyanyi
six	enam
skin	kulit
slay	bunuh	membunuh
slender	kurus	tipis
slow	lambat
small	kecil
smoke	asap
so	begini	begitu	begini	begitu	begini	begitu
soap	sabun
sock	kaus
soft	manis	empuk	halus
sole	sendiri
solitary	sendiri
some	agak
somewhat	agak
soon	segera
sort	jenis	macam
sound	bunyi	suara
source	mata-air
south	selatan
spade	gali	menggali
special	khusus	khusus
specialist	ahli
speedy	jepat	lekas
spoon	sendok
spring	mata-air	lompat	melompat
squirrel	bajing
stand	bangkit	bangkit
stand up	bangkit	bangkit
statement of policy	acara	rencana
station	setasiun
statue	arca
steal	curi	mencuri
still	masih
stomach	perut
stone	batu
store	toko
storm	badai
story	sejarah	cerita
straightforward	sederhana
strange	asing
strike	memukul	pukul
string	tali	tampar
strong	kuat
student	pelajar
study	mempelajari
sturdy	gagah
such	begini	begitu
such a	sebagai
such as	sebagai
suck	isap	mengisap
suffer	derita	menderita
sufficiently	agak
sugar	gula
suitable	berguna	berguna
suitcase	kopor
sum	jumlah
sun	matahari
sweat	berkeringat	keringat
sweet	manis
swift	jepat	lekas
swim	berenang
swine	babi
switch	loncat	meloncat
table-cloth	taplak-meja
tailor	penjahit
take	menerima	terima
take in	menerima	terima
tale	cerita
tall	tinggi
tangle	kekacauan
target	maksud
tax	pajak
taxi	taksi
tea	teh
teach	ajar	mengajar
teacher	pengajar
tear	air-mata
tell a lie	mendusta
temple	kuil
ten	sepuluh
tender	manis
test	coba	mencoba
that	apa	begini	begitu
that’s all right	tidak apa apa
that’s okay	tidak apa apa	tidak apa apa
that way	begini	begitu
these days	dewasa ini	sekarang
thin	kurus	tipis
thing	benda	benda
think	berpikir	fikir
thorn	duri
thread	benang
three	tiga
through	siap	melalui
throw	lempar	melempar
throw away	buang	membuang
throw up	muntah
thrust	desak	mendesak	dorong	mendorong
thus	begini	begitu	begini	begitu
ticket	karcis
tie	dasi	ikat	mengikat
tie up	ikat	mengikat
tight	erat
timber	kayu
time	jam
timid	takut
tire	ban
tired	lelah
tobacco	tembakau
toilet	kakus
token	bukti	tanda
tongue	lidah	bahasa
tool	alat	perkakas
tooth-brush	sikat-gigi
torture	penganiayaan	aniaya	menganiaya
towel	handuk
to some extent	agak
train	kereta-api	kereta-api
transmit	kirim
transport	angkut	mengangkut
travel	bepergian
tree	pohon
trip	perjalanan
trousers	celana
try	coba	mencoba
turn	baris
turn on	loncat	meloncat
two	dua
typewriter	mesintik
tyre	ban
ugly	buruk	jelek
ultimately	akhirnya
umbrella	payung
uncertain	tak pasti
underestimate	abai	mengabaikan
understand	mengerti
uniform	seragam
upon	lawan
upset	bingung
us	kami
use	gunakan	menggunakan	guna
used to	biasa
usual	biasa	biasa
usually	biasanya
valiant	berani
valise	kopor
valley	lembah
valuable	mahal
vehicle	kendaraan
verdict	hukuman
victim	korban	kurban
village	kampung
visa	visa
visit	kunjungi	mengunjungi	kunjungan
visé	visa
voice	suara	suara
void	kosong	leher
volcano	gunung-api
vomit	muntah
vote	memungut suara	pungut suara	suara
voyage	perjalanan
wage	gaji	salaris
wages	gaji	salaris
waist	pinggang
waistline	pinggang
wait	harapkan	mengharapkan	menunggu	tunggu
waiter	pelayan restoran
wait for	harapkan	mengharapkan	menunggu	tunggu
wake	membanguni	bangun
wake up	membanguni	bangun
wall	dinding
want	keperluan	mau
watch	arloji-tangan	arloji-tangan
watch out for	menanti
water	air
waterfall	air-terjun	air-terjun
wave	ombak
way	adat	kebiasaan	cara
we	kami
weak	lemah
wear	angkat	mengangkat
weather	hawa	udara
well-mannered	adab	beradab	adab	beradab	sopan
well	sehat
west	barat
wet	basah	membasahkan
what	apa	apa
what a	sebagai
wheel	roda
whisper	bisik	berbisik-bisik
wind	angin
wing	sayap
wish	mau
without	tanpa
woman	wanita
wonted	biasa
wood	kayu
work	kerja
worker	pekerja
working man	pekerja
workman	pekerja
world	dunia
wrangle	berbantah
wrench	kunci
wrist-watch	arloji-tangan
writer	pengarang
yellow	kuning
yet	masih	sudah
young	muda
you’re welcome	tidak apa apa
zero	nol
zinc	seng
zoo	kebun-binatang
